tileswide 10
tileshigh 10
tilewidth 32
tileheight 32

layer 0
8,8,8,8,8,8,8,8,8,8,
8,8,8,8,8,8,8,8,8,8,
2,8,8,8,8,8,8,8,8,7,
3,8,8,8,8,8,8,8,8,6,
3,8,8,7,1,1,2,8,8,6,
4,2,8,6,0,0,3,8,7,5,
9,4,1,5,0,0,4,1,5,13,
10,11,11,11,11,11,11,11,11,12,
14,14,14,14,14,14,14,14,14,14,
15,16,16,16,16,16,16,16,16,17,

